EA ./assets/brick.png
NO ./assets/stone.png
WE ./assets/wood.png
SO ./assets/grass.png

C 50,100,1000
F 0,153,51

        11111111111111111111111
        10000000001100011110001           
        10110000011100011111111    
        10010000000000000000001
1111111110110000011100000000011
1000000000110000011101111111111
11101111111110111000000100011
11110111111111011101010010001
11111000011010101110000001001
10000000000000001100000011111
10000000000000001101010000011
111110001110101011111011110N1
11110111 1110101 101111010001
11111111 1111111 111111111111