EA ./assets/brick_east.png
NO ./assets/stone_north.png
WE ./assets/wood_west.png
SO ./assets/grass_south.png

C 50,100,100
F 0,153,51

        11111111111111111111111
        10000000001100011110001
        10110000011100011111111
        10010000000000000000001
1111111110110000011100000000011
1000000000110000011101111111111
1110111111111011100000010000011
1111011111111101110101001000001
11111000011010101 1100000000101
10000000000000001100N0001011111
1000000000000000110101000000011
1111100011101010111110001111001
11110111 1110101 10111101000001
11111111 1111111 11111111111111