

EA ./assets/brick.png
NO ./assets/stone

WE ./assets/wood.png
SO ./assets/grass.png

F 128,125,125
C 225,30,111

   N     111N11111111111111    111111 1
        10000000001100001    10001  1           
        10110000011100011111100011  1    
    N    100100000000000000000000001
1111111110110000011100000000000011111
100000000011000001110111111111111
111101111111110111000000100011
11111111111111111111111111111
11100000000000000000000000111
11111000011010101110000001001
    1000000100000000110000001
    1000000000000000110101001
11111000111010101111101111001
11110111 1110101 101111011111
11111111 1111111 1111N111111