EA ./assets/brick.png
NO ./assets/stone.png

WE ./assets/wood.png
SO ./assets/grass.png

F 128,125,123
C 225,30,111

        111111111111111111    111111 1
        10000000001100001    10001  1           
         10110000011100011111100011  1    
        100100000000000000000000001
1111111110110000011100000000000011111
100000000011000001110111111111111
11110111111111011100000010001
11111111111111111111111111111
1110000000000W000000000000111
1111100001111010111100000010011
   1000001010001 10001100000101
    100000111000100000110101001     1
111110001110101011111011110011
11110111 1110101 101111011111
11111111 111111 111111111
1
