EA ./assets/brick.png
NO ./assets/stone.png
WE ./assets/wood.png
SO ./assets/grass.png

C 50,100,100
F 0,153,51

11111
10001
1N101
10001
11111