
EA ./assets/brick.png
NO ./assets/stone.png
WE ./assets/wood.png
SO ./assets/grass.png

C 225,30,0
F 220,100,0

        1111111111111111    11111
        1000000000110001    10001           
        10110000011100011111100011111    
        10010000000000000000000000001
1111111110110000011100000000000011111
100000000011000001110111111111111
111101111111110111000000100011
11111111111111111111111111111

111000000000000000000000000000000000111
11111000011010101110000001001
    1000000000000000110000001
    1000000000000000110101001
111110001110101011111011110N1
11110111 1110101 101111011111
11111111 1111111 111111111111
